F 181,55,53
C 67,138,122

NO pattern/north_wall.png
SO pattern/south_wall.png
WE pattern/west_wall.png
EA pattern/east_wall.png

1111111111111111111
1000000000000000001
1000000000000000001
1000000000000000001
1000000000000000001
1000000W00000000001
1000000000000000001
1000000000000000001
1000000000000000001
1111111111111111111